1111111111111
10010000B00C1
1000011111001
1P0011E0B0001
1111111111111
